####################GGGGGGGGGGGGGGGGGGGG
####################GGGGGGGGGGGGGGGGGGGG
#S###################################F#G
#G################G#GGGGGGGGGGGGGGGGGGGG
#G#C#C#C#C#C#C#C#G#GGGGGGGGGGGGGGGGGGGG
#G#C#G#G#G#G#G#C#G#GGGGGGGGGGGGGGGGGGGG
#G#C#G#######G#CGG#GGGGGGGGGGGGGGGGGGGG
#G#C#G#CCCCC#G#C#G#GGGGGGGGGGGGGGGGGGGG
#G#C#G#C###C#G#C#G#GGGGGGGGGGGGGGGGGGGG
#G#C#G#C#G#C#GGC#G#GGGGGGGGGGGGGGGGGGGG
#G#C#G#C#G#C#G#C#G#GGGGGGGGGGGGGGGGGGGG
#G#C#G#C#G#C#G#C#G#GGGGGGGGGGGGGGGGGGGG
#G#C#G#CCC#C#G#CGG#GGGGGGGGGGGGGGGGGGGG
#G#C#GGGGGGG#G#C#G#GGGGGGGGGGGGGGGGGGGG
#G#CCCCCCCCCCC#C#G#GGGGGGGGGGGGGGGGGGGG
GGGGGGGGGGGGGGGGGGGGGGGGGGGGGGGGGGGGGGGG

