##########################################################################################
##########################################################################################
##########################################################################################
##########################################################################################
##########################################################################################
##########################################################################################
##########################################################################################
##########################################################################################
##########################################################################################
##########################################################################################
##########################################################################################
##########################################################################################
##########################################################################################
##########################################################################################
#####C###C###C###C###C###C#######C###C###C###CC###########################################
####C#C#C#C#C#C#C#C#C#C#C#C#C#C#C#C#C#C#C#C#C##C##########################################
#####S#######################C############################################################
##C#GGG#G###G#G#GGG#GGG#GCG#####GGC#GGG#GGG#GC#G#C########################################
##C#GCC#G###G#G#GCC#GCC#GCG#####G#G#GCC#G#G#GGCG#C########################################
##C#GGG#G###G#G#GGG#GGG#GGG#GGG#GGG#GGG#GGG#G#GG#C########################################
##C#G###GCC#G#G#G###G#####G#####G#G#GCC#GCG#G##G#C########################################
##C#G###GGG#GGG#G###G#####G#####GGC#GGG#GCG#G##G#C########################################
#####C###C###C###C###C###C###C###C###C###C###CC###########################################
###GC#CGC#CGC#CGC#CGC#CGC#CGC#CGC#CGC#CGC#CGC##CGF########################################
##GGG#GGG#GGG#GGG#GGG#GGG#GGG#GGG#GGG#GGG#GGG##GGG########################################
##########################################################################################
##########################################################################################
##########################################################################################
##########################################################################################
##########################################################################################
