########################################
####CCCC################################
#S###################################F##
#GGGGGGGGGGGGGGGGGGGGGGGGGGGGGGGGGGGGG##
########################################
########################################
########################################
########################################
########################################
########################################
########################################
########################################
########################################
########################################
########################################
########################################


