########################################
####CCC#################################
#S###################################F##
#GGGGGGGGGGGGGGGGGGGGGGGGGGGGGGGGGGGGG##
########################################
########################################
########################################
########################################
########################################
########################################
########################################
########################################
########################################
########################################
########################################
########################################


